7,7,,,,,
1,1,1,1,1,1,1
1,3,3,3,3,3,1
1,3,3,4,4,3,1
1,3,3,3,3,3,1
1,3,3,3,3,3,1
1,3,3,3,3,3,1
1,1,1,1,1,1,1
,,,,,,
1,1,1,1,1,1,1
1,6,2,0,0,0,1
1,7,2,0,0,0,1
1,0,2,0,0,0,1
1,0,0,0,0,0,1
1,0,2,0,0,0,1
1,1,1,1,1,1,1
