8,8,,,,,,
1,1,1,1,1,1,1,1
1,3,3,3,3,5,4,1
1,3,3,3,3,11,10,1
1,3,3,3,3,3,3,1
1,3,3,3,3,3,3,1
1,3,3,3,3,3,3,1
1,3,3,3,3,3,3,1
1,1,1,1,1,1,1,1
,,,,,,,
1,1,1,1,1,1,1,1
1,2,2,2,2,0,0,1
1,6,7,2,0,0,0,1
1,8,9,2,0,2,0,1
1,2,0,0,0,0,0,1
1,2,0,0,0,2,0,1
1,2,0,0,0,0,0,1
1,1,1,1,1,1,1,1
