7,7,,,,,
1,1,1,1,1,1,1
1,3,3,3,5,4,1
1,3,3,3,5,4,1
1,3,3,3,3,3,1
1,3,3,3,3,3,1
1,3,3,3,3,3,1
1,1,1,1,1,1,1
,,,,,,
1,1,1,1,1,1,1
1,0,0,0,0,0,1
1,0,2,2,0,0,1
1,0,2,2,0,0,1
1,0,2,2,9,7,1
1,0,0,0,6,8,1
1,1,1,1,1,1,1
