7,7,,,,,
1,1,1,1,1,1,1
1,3,4,5,4,3,1
1,3,3,3,3,3,1
1,3,3,3,3,3,1
1,3,3,3,3,3,1
1,3,3,3,3,3,1
1,1,1,1,1,1,1
,,,,,,
1,1,1,1,1,1,1
1,2,0,0,0,2,1
1,0,0,0,0,0,1
1,0,0,2,0,0,1
1,0,2,0,2,0,1
1,0,2,6,8,7,1
1,1,1,1,1,1,1
