5,5,,,
1,1,1,1,1
1,3,3,4,1
1,3,3,3,1
1,3,3,3,1
1,1,1,1,1
,,,,
1,1,1,1,1
1,2,0,0,1
1,0,0,0,1
1,6,0,2,1
1,1,1,1,1
