8,8,,,,,,
1,1,1,1,1,1,1,1
1,3,3,3,3,3,3,1
1,3,3,3,3,3,3,1
1,3,3,3,3,3,3,1
1,3,3,3,3,3,3,1
1,11,4,5,3,3,3,1
1,10,5,4,3,3,3,1
1,1,1,1,1,1,1,1
,,,,,,,
1,1,1,1,1,1,1,1
1,2,8,9,9,2,2,1
1,0,2,0,2,7,2,1
1,0,0,0,0,6,0,1
1,0,0,2,2,7,2,1
1,0,0,0,0,0,0,1
1,0,0,0,0,0,0,1
1,1,1,1,1,1,1,1
