9,9,,,,,,,
1,1,1,1,1,1,1,1,1
1,3,3,3,3,3,3,3,1
1,3,3,3,3,3,3,3,1
1,3,3,3,3,3,3,3,1
1,3,3,3,3,3,3,10,1
1,3,3,3,3,3,3,5,1
1,3,3,3,3,3,3,4,1
1,3,3,3,3,3,3,11,1
1,1,1,1,1,1,1,1,1
,,,,,,,,
1,1,1,1,1,1,1,1,1
1,0,2,0,2,0,0,0,1
1,9,8,0,2,0,0,0,1
1,2,0,0,0,2,0,2,1
1,0,0,0,2,6,7,0,1
1,2,2,0,0,0,2,0,1
1,0,2,0,0,0,2,0,1
1,0,0,0,0,0,2,0,1
1,1,1,1,1,1,1,1,1
