7,7,,,,,
1,1,1,1,1,1,1
1,3,3,3,3,4,1
1,3,3,3,3,11,1
1,3,3,3,3,4,1
1,3,3,3,3,10,1
1,3,3,3,3,3,1
1,1,1,1,1,1,1
,,,,,,
1,1,1,1,1,1,1
1,2,2,0,2,0,1
1,8,2,0,0,0,1
1,7,0,0,0,0,1
1,6,2,0,0,0,1
1,7,0,0,2,0,1
1,1,1,1,1,1,1
