7,7,,,,,
1,1,1,1,1,1,1
1,3,3,3,10,4,1
1,3,3,3,3,4,1
1,3,3,3,3,3,1
1,3,3,3,3,3,1
1,3,3,3,3,3,1
1,1,1,1,1,1,1
,,,,,,
1,1,1,1,1,1,1
1,0,0,0,0,0,1
1,0,0,2,2,0,1
1,2,0,0,0,0,1
1,2,0,0,0,2,1
1,2,7,7,6,2,1
1,1,1,1,1,1,1
