9,9,,,,,,,
1,1,1,1,1,1,1,1,1
1,3,3,3,3,3,3,3,1
1,4,10,3,3,3,3,3,1
1,3,11,5,3,3,3,3,1
1,3,3,3,3,3,3,3,1
1,3,3,3,3,3,3,3,1
1,3,3,3,3,3,3,3,1
1,3,3,3,3,3,3,3,1
1,1,1,1,1,1,1,1,1
,,,,,,,,
1,1,1,1,1,1,1,1,1
1,2,0,2,2,0,0,0,1
1,0,0,0,0,0,0,0,1
1,0,0,0,0,2,0,0,1
1,0,0,2,2,0,0,2,1
1,2,2,0,0,0,0,2,1
1,6,8,0,0,0,2,2,1
1,7,9,2,2,2,2,2,1
1,1,1,1,1,1,1,1,1
