7,7,,,,,
1,1,1,1,1,1,1
1,3,10,4,11,3,1
1,3,3,3,3,3,1
1,3,3,3,3,3,1
1,3,3,3,3,3,1
1,3,3,3,3,3,1
1,1,1,1,1,1,1
,,,,,,
1,1,1,1,1,1,1
1,0,0,0,0,0,1
1,0,2,2,2,0,1
1,0,0,0,0,0,1
1,2,0,0,0,2,1
1,2,6,8,7,2,1
1,1,1,1,1,1,1
