7,7,,,,,
1,1,1,1,1,1,1
1,3,3,3,3,3,1
1,3,3,3,3,3,1
1,3,3,3,3,3,1
1,3,3,3,11,10,1
1,3,3,3,4,5,1
1,1,1,1,1,1,1
,,,,,,
1,1,1,1,1,1,1
1,0,0,2,7,0,1
1,0,0,0,6,2,1
1,2,0,2,0,0,1
1,9,8,0,0,0,1
1,0,2,0,0,0,1
1,1,1,1,1,1,1
