8,8,,,,,,
1,1,1,1,1,1,1,1
1,3,3,3,3,3,3,1
1,3,3,3,3,3,3,1
1,3,3,3,3,3,3,1
1,3,3,3,3,3,3,1
1,3,3,4,10,3,3,1
1,3,5,11,3,3,3,1
1,1,1,1,1,1,1,1
,,,,,,,
1,1,1,1,1,1,1,1
1,2,6,2,2,8,2,1
1,2,7,2,2,9,2,1
1,0,0,0,0,0,0,1
1,0,0,0,0,0,0,1
1,2,0,0,0,0,2,1
1,2,0,0,0,0,2,1
1,1,1,1,1,1,1,1
