9,9,,,,,,,
1,1,1,1,1,1,1,1,1
1,3,3,3,3,3,3,3,1
1,3,3,3,3,3,3,3,1
1,3,3,3,3,3,3,3,1
1,3,3,3,3,3,3,3,1
1,3,3,3,3,3,3,3,1
1,3,3,3,3,3,5,4,1
1,3,3,3,10,4,11,3,1
1,1,1,1,1,1,1,1,1
,,,,,,,,
1,1,1,1,1,1,1,1,1
1,0,2,2,6,7,7,0,1
1,9,0,2,2,2,2,0,1
1,8,2,2,0,0,0,0,1
1,0,0,0,0,0,2,0,1
1,0,2,0,0,0,0,0,1
1,0,0,2,2,0,0,0,1
1,0,2,0,0,0,0,0,1
1,1,1,1,1,1,1,1,1
