7,7,,,,,
1,1,1,1,1,1,1
1,4,3,3,3,3,1
1,4,3,3,3,3,1
1,3,3,3,3,3,1
1,3,3,3,3,3,1
1,3,3,3,3,3,1
1,1,1,1,1,1,1
,,,,,,
1,1,1,1,1,1,1
1,0,0,0,0,0,1
1,0,0,2,2,2,1
1,0,2,0,0,0,1
1,0,2,2,7,0,1
1,0,0,0,6,0,1
1,1,1,1,1,1,1
