7,7,,,,,
1,1,1,1,1,1,1
1,3,3,3,3,3,1
1,3,3,3,5,3,1
1,3,3,4,5,4,1
1,3,3,3,3,3,1
1,3,3,3,3,3,1
1,1,1,1,1,1,1
,,,,,,
1,1,1,1,1,1,1
1,2,2,0,2,0,1
1,2,2,0,0,0,1
1,7,6,0,0,0,1
1,2,2,0,0,0,1
1,9,8,0,0,0,1
1,1,1,1,1,1,1
