8,8,,,,,,
1,1,1,1,1,1,1,1
1,4,11,3,3,3,3,1
1,4,5,3,3,3,3,1
1,10,3,3,3,3,3,1
1,3,3,3,3,3,3,1
1,3,3,3,3,3,3,1
1,3,3,3,3,3,3,1
1,1,1,1,1,1,1,1
,,,,,,,
1,1,1,1,1,1,1,1
1,0,0,0,0,0,0,1
1,0,0,0,0,0,2,1
1,0,2,0,0,2,2,1
1,2,0,2,0,8,2,1
1,7,6,7,0,9,0,1
1,2,0,0,0,2,0,1
1,1,1,1,1,1,1,1
