8,8,,,,,,
1,1,1,1,1,1,1,1
1,10,4,4,3,3,3,1
1,5,5,11,3,3,3,1
1,3,3,3,3,3,3,1
1,3,3,3,3,3,3,1
1,3,3,3,3,3,3,1
1,3,3,3,3,3,3,1
1,1,1,1,1,1,1,1
,,,,,,,
1,1,1,1,1,1,1,1
1,0,0,0,0,0,0,1
1,0,0,0,2,2,7,1
1,2,0,0,0,0,6,1
1,0,0,2,0,2,7,1
1,0,0,0,2,0,2,1
1,0,0,0,9,8,9,1
1,1,1,1,1,1,1,1
