8,8,,,,,,
1,1,1,1,1,1,1,1
1,3,3,3,3,3,3,1
1,3,3,3,3,3,11,1
1,3,3,3,3,4,5,1
1,3,3,3,3,10,3,1
1,3,3,3,3,3,3,1
1,3,3,3,3,3,3,1
1,1,1,1,1,1,1,1
,,,,,,,
1,1,1,1,1,1,1,1
1,6,7,0,0,0,0,1
1,2,0,2,2,0,0,1
1,2,2,2,0,0,0,1
1,8,2,0,2,0,0,1
1,9,2,0,0,0,2,1
1,0,0,0,0,0,0,1
1,1,1,1,1,1,1,1
