7,7,,,,,
1,1,1,1,1,1,1
1,3,3,3,5,5,1
1,3,3,3,4,4,1
1,3,3,3,3,3,1
1,3,3,3,3,3,1
1,3,3,3,3,3,1
1,1,1,1,1,1,1
,,,,,,
1,1,1,1,1,1,1
1,2,2,2,0,0,1
1,2,2,2,0,0,1
1,0,0,2,0,0,1
1,6,9,0,0,0,1
1,8,7,2,0,0,1
1,1,1,1,1,1,1
