9,9,,,,,,,
1,1,1,1,1,1,1,1,1
1,3,3,3,3,3,3,3,1
1,3,3,3,4,4,10,3,1
1,3,3,3,5,3,5,3,1
1,3,3,3,3,3,11,3,1
1,3,3,3,3,3,3,3,1
1,3,3,3,3,3,3,3,1
1,3,3,3,3,3,3,3,1
1,1,1,1,1,1,1,1,1
,,,,,,,,
1,1,1,1,1,1,1,1,1
1,2,0,2,0,2,0,2,1
1,2,0,0,0,0,0,0,1
1,0,0,0,0,0,0,2,1
1,2,0,0,2,0,0,2,1
1,0,9,0,2,2,7,0,1
1,2,9,8,2,0,6,2,1
1,2,2,0,2,2,7,2,1
1,1,1,1,1,1,1,1,1
