5,5,,,
1,1,1,1,1
1,3,4,5,1
1,3,3,3,1
1,3,3,3,1
1,1,1,1,1
,,,,
1,1,1,1,1
1,2,0,0,1
1,0,0,0,1
1,6,2,8,1
1,1,1,1,1
