8,8,,,,,,
1,1,1,1,1,1,1,1
1,3,3,3,3,3,3,1
1,3,3,3,3,3,3,1
1,3,3,3,3,3,3,1
1,3,3,3,3,3,3,1
1,3,3,3,3,3,3,1
1,3,4,11,10,5,3,1
1,1,1,1,1,1,1,1
,,,,,,,
1,1,1,1,1,1,1,1
1,0,0,8,6,0,2,1
1,2,0,9,7,0,2,1
1,0,2,0,0,0,2,1
1,0,0,2,0,0,0,1
1,2,0,0,0,2,0,1
1,2,0,0,0,0,2,1
1,1,1,1,1,1,1,1
