8,8,,,,,,
1,1,1,1,1,1,1,1
1,3,3,3,3,3,3,1
1,3,3,3,3,3,3,1
1,3,3,4,4,3,3,1
1,3,3,4,5,3,3,1
1,3,3,3,3,3,3,1
1,3,3,3,3,3,3,1
1,1,1,1,1,1,1,1
,,,,,,,
1,1,1,1,1,1,1,1
1,8,7,0,2,0,0,1
1,0,2,0,0,2,0,1
1,2,0,0,0,0,0,1
1,0,0,0,0,0,2,1
1,0,2,0,0,2,0,1
1,0,0,2,0,7,6,1
1,1,1,1,1,1,1,1
