8,8,,,,,,
1,1,1,1,1,1,1,1
1,3,3,3,3,5,10,1
1,3,3,3,3,11,4,1
1,3,3,3,3,3,4,1
1,3,3,3,3,3,3,1
1,3,3,3,3,3,3,1
1,3,3,3,3,3,3,1
1,1,1,1,1,1,1,1
,,,,,,,
1,1,1,1,1,1,1,1
1,0,0,0,0,0,0,1
1,2,0,0,0,0,0,1
1,2,0,0,0,0,0,1
1,2,6,2,0,0,2,1
1,7,8,0,0,2,2,1
1,9,7,2,2,2,2,1
1,1,1,1,1,1,1,1
