8,8,,,,,,
1,1,1,1,1,1,1,1
1,3,3,3,3,4,4,1
1,3,3,3,3,4,3,1
1,3,3,3,3,4,3,1
1,3,3,3,3,3,3,1
1,3,3,3,3,3,3,1
1,3,3,3,3,3,3,1
1,1,1,1,1,1,1,1
,,,,,,,
1,1,1,1,1,1,1,1
1,2,0,0,2,0,0,1
1,0,0,0,0,0,0,1
1,2,0,0,2,0,0,1
1,2,0,0,0,0,0,1
1,0,2,0,2,0,2,1
1,7,7,7,6,0,2,1
1,1,1,1,1,1,1,1
