7,7,,,,,
1,1,1,1,1,1,1
1,3,3,4,3,3,1
1,3,3,5,3,3,1
1,3,3,3,3,3,1
1,3,3,3,3,3,1
1,3,3,3,3,3,1
1,1,1,1,1,1,1
,,,,,,
1,1,1,1,1,1,1
1,0,0,0,0,0,1
1,0,0,0,0,0,1
1,0,2,2,2,0,1
1,0,0,2,0,0,1
1,6,0,2,0,8,1
1,1,1,1,1,1,1
