8,8,,,,,,
1,1,1,1,1,1,1,1
1,3,3,3,3,3,3,1
1,3,3,3,11,3,3,1
1,3,3,4,5,3,3,1
1,3,3,10,3,3,3,1
1,3,3,3,3,3,3,1
1,3,3,3,3,3,3,1
1,1,1,1,1,1,1,1
,,,,,,,
1,1,1,1,1,1,1,1
1,2,0,0,0,2,2,1
1,2,0,0,0,7,2,1
1,0,0,0,0,6,2,1
1,2,8,0,0,0,0,1
1,2,9,0,0,0,2,1
1,2,2,0,0,0,2,1
1,1,1,1,1,1,1,1
