9,9,,,,,,,
1,1,1,1,1,1,1,1,1
1,3,3,3,3,3,3,3,1
1,3,10,3,3,3,3,3,1
1,4,11,4,3,3,3,3,1
1,3,3,3,3,3,3,3,1
1,3,3,3,3,3,3,3,1
1,3,3,3,3,3,3,3,1
1,3,3,3,3,3,3,3,1
1,1,1,1,1,1,1,1,1
,,,,,,,,
1,1,1,1,1,1,1,1,1
1,0,2,0,0,0,0,8,1
1,0,0,0,2,2,0,7,1
1,0,0,0,0,2,2,2,1
1,0,2,0,0,2,0,2,1
1,2,2,0,0,0,0,0,1
1,6,0,0,0,0,0,0,1
1,7,0,2,0,2,2,2,1
1,1,1,1,1,1,1,1,1
