8,8,,,,,,
1,1,1,1,1,1,1,1
1,3,3,3,3,3,10,1
1,3,3,3,3,4,5,1
1,3,3,3,3,11,4,1
1,3,3,3,3,3,3,1
1,3,3,3,3,3,3,1
1,3,3,3,3,3,3,1
1,1,1,1,1,1,1,1
,,,,,,,
1,1,1,1,1,1,1,1
1,0,0,0,0,0,0,1
1,8,2,0,0,0,0,1
1,9,0,2,2,0,0,1
1,6,2,0,0,0,0,1
1,7,0,2,0,0,0,1
1,7,0,0,0,2,0,1
1,1,1,1,1,1,1,1
